#############################
#@......#...........#.......#
#.......#.....z.....#...z...#
#...#...#...........#.......#
#...#...######.######...#...#
#...#...........D.......#...#
#...#########...#########...#
#...#.......#...#.......#...#
#.......b...........B.......#
#...#.......#...#.......#...#
#############################