#############################
#.......#...........#.......#
#...k.......M.......C...k...#
#.......#...........#.......#
#...#####.#########.#####...#
#...#.......#Q.B#.......#...#
#...#####...#...#...#####...#
#.......#...........#.......#
#...q.......#...#.......q...#
#.......#...#...#...#.......#
#########...#...#...#########
#...........#...#...........#
#...@.......#...#...........#
#############################