#########################
#@......#.......#.......#
#.......#...s...#...k...#
#...#...#.......#.......#
#...#...####.####...#...#
#...#...............#...#
#...#############...#...#
#.......#.......#.......#
#...q.......Q.......B...#
#.......#.......#.......#
#########################